{
  "錒": "锕",
  "鎄": "锿",
  "皚": "皑",
  "噯": "嗳",
  "藹": "蔼",
  "靄": "霭",
  "愛": "爱",
  "礙": "碍",
  "嬡": "嫒",
  "璦": "瑷",
  "靉": "叆",
  "暧": "暧",
  "諳": "谙",
  "鵪": "鹌",
  "銨": "铵",
  "骯": "肮",
  "鰲": "鳌",
  "襖": "袄",
  "驁": "骜",
  "䰾": "鲃",
  "鈀": "钯",
  "壩": "坝",
  "罷": "罢",
  "鮁": "鲅",
  "擺": "摆",
  "敗": "败",
  "頒": "颁",
  "闆": "板",
  "鈑": "钣",
  "辦": "办",
  "絆": "绊",
  "幫": "帮",
  "綁": "绑",
  "謗": "谤",
  "鎊": "镑",
  "齙": "龅",
  "飽": "饱",
  "寶": "宝",
  "鴇": "鸨",
  "報": "报",
  "鮑": "鲍",
  "鵯": "鹎",
  "貝": "贝",
  "狽": "狈",
  "備": "备",
  "鋇": "钡",
  "憊": "惫",
  "輩": "辈",
  "唄": "呗"
}